00000111111110111110
01011100000010000010
01110001111010111110
01000101001010100100
01110101101010110100
00011100101010010100
01110101101110110110
00000101000000010011
01111101110001010000
11000000011111011110
01111111110101000010
00000001000001000110
01111101000101100100
01000100000100100110
01100111111111100100
00100000000000000110
01100111100111110010
01000100101100011010
01100100101000001110
00111100111111110000
