00000000000000000000
01111111110000000000
01010000010011111100
01010000011110000110
01010111110000111010
01010100010001101110
11110110010111001000
01010010011100001000
01010011101000111100
01010000101000100100
01111111111111100000
01010000001000111100
01010001111000100100
01010001001000100100
01111111111000100100
00010000001000100110
00010001111111100010
00010011000000000011
00011110000000000000
00000000000000000000
