00011111100000000000
00100000111100000000
00100000100101111110
01111111100101000100
01010010000111100100
11110111110100000100
01010000000100000100
10010001000000000100
11011101011111111100
01010001010000100000
01010000110000100000
11010111100000101111
10010100000001011000
11110100011111001100
01000100010001000100
01001111110111111100
01000100000100000000
01000111111110000000
01110000000011111110
00011111110000000000
