00000000000000000000
00011111111111100000
00010000000000100000
00010000000001111000
00011111111101001000
11110000000101001000
01000000000101001110
01000000011101000010
01111110010001000010
00000010010001000010
00000011111111111110
00001110000001000100
00001000111111000100
00001111100000000100
11111001000000000100
00000001111111111100
00111111000000000100
00100000000000000100
00100000000000000110
00000000000000000011
