00011111111100000000
00110000000100011110
00101110100110010010
00111011111010110010
00000000001010010110
11111011101010010100
00101010111011010110
00111010010110010100
01101110010101110110
01000000000101001010
01110111011101101010
00010101010101011010
01110101010001101011
01000101110000101100
01100100001111101010
01011101000001011010
01100111111111010110
00100000000000010100
00111111111111110110
00000000010000001000
