01000000000001110100
01111111001111011100
00010001010100010010
01101101110111010010
01010001010101010110
01011101011001011010
01000101011111001010
11100101100001011010
00111101110001010100
00100101011101011100
01110010100101110110
01011110111101010010
01000100011001011010
01110100010111100110
00011111010100011011
01110001110100101100
01011111001111100110
01000000011100111100
01110111110100101010
01011100010111101100
